NO ./path_to_the_north_texture
SO ./path_to_the_south_texture			    
WE ./path_to_the_west_texture   
EA ./path_to_the_east_texture  				

F 255,100,0
C 225,30,108

                            111111111111
                           10000000000001
                          1000000000000001
                         100000000000000001
                        10000000000000000001
                       1000000000000000000001
                      100000000001100000000001
                     100000000001  100000000001
                    100000000001    100000000001
                   100000000001      100000000001
                  100000000001        100000000001
                 100000000001          100000000001
                100000000001            100000000001
               100000000001              100000000001
              1000000000011111111111111111100000000001
             100000000000000000000000000000000000000001
            10000000000000000000000000000000000000000001
           1000000000000000000000000000000000000000000001
          100000000000000000000000000000000000000000000001
         10000000000111111111111111111111111111100000000001
        1000000N00001                           100000000001
       1000000000001                             100000000001
      1000000000001                               100000000001
     1000000000001                                 100000000001
    1000000000001                                   100000000001
   1000000000001                                     100000000001
  1000000000001                                       100000000001
 1111111111111                                         111111111111