NO ./path_to_the_north_texture
SO ./path_to_the_south_texture			    
WE ./path_to_the_west_texture   
EA ./path_to_the_east_texture  				

F 255,100,0
C 225,30,108

111111111111                  111111111111
 100000000001                100000000001
  100000000001              100000000001
   100000000001            100000000001
    100000000001          100000000001
     100000000001        100000000001
      100000000001      100000000001
       100000000001    100000000001
        100000000001  100000000001
         100000000001100000000001
          1000000000000000000001
           10000000000000000001
            100000000000000001
             10000000N0000001
			  10000000000001
			   100000000001
               100000000001
               100000000001
               100000000001
               100000000001
               100000000001
               100000000001
               100000000001
               100000000001
               100000000001
               100000000001
               100000000001
               111111111111