NO ./path_to_the_north_texture
SO ./path_to_the_south_texture			
			                       F 220,100,0



WE ./path_to_the_west_texture
			EA ./path_to_the_east_texture


C 225,30,0


1111111111111
1000101000001
1001000100001
1000000001001
10E0000001001
1000000001001
1000000001001
1111111111111