NO ./path_to_the_north_texture
SO ./path_to_the_south_texture			    
WE ./path_to_the_west_texture   
EA ./path_to_the_east_texture  				

F 255,100,0
C 225,30,108

11111111111111111111111111111111111111111111111111111111111111111111111111111111
10000000000000000000000000000000000000000000000000000000000000000000000000000001
10000000000000000000000000000000000000000000000000000000000000000000000000000001
10000000000000000000000000000000000000000000000000000000000000000000000000000001
10000000000000000000000000000000000000000000000000000000000000000000000000000001
10000111111111111111111111111111111111111111111111111111111111111111111111100001
100001                                                                    100001
100001                                                                    100001
100001  1111111111111111111111111111111111111111111111111111111111111111  100001
100001  1000000000000000000000000000000000000000000000000000000000000001  100001
100001  1000000000000000000000000000000000000000000000000000000000000001  100001
100001  1000000000000000000000000000000000000000000000000000000000000001  100001
100001  1000000000000000000000000000000000000000000000000000000000000001  100001
100001  1111111111111111111111111111111111111111111111111111111111111111  100001
100001                                                                    100001
100001                                                                    100001
10000111111111111111111111111111111111111111111111111111111111111111111111100001
10000000000000000000000000000000000000000000000000000000000000000000000000000001
10000000000000000000000000000000000000000000000000000000000000000000000000000001
10000000000000000000000000000000000000000000000000000000000000000000000000000001
10000000000000000000000000000000000000000000000000000000000000000000000000000001
11111111111111111111111111111111111111111111111111111111111111111111111111111111



* - * - * - * - * - * - * - * - * - * - * - * - * - * - * - * - * - * - * - * - * 



1111111111     11111111111111111111111111111111111111111111111111111111111111111
1000000001     10000000000000000000000000000000000000000000000000000000000000001
1000000001     10000000000000000000000000000000000000000000000000000000000000001
1000000001     10000000000000000000000000000000000000000000000000000000000000001
1000000001     10000000000000000000000000000000000000000000000000000000000000001
1000000001     10000000000000000000000000000000000000000000000000000000000000001
1111111111     10000000000000000000000000000000000000000000000000000000000000001
               10000000000000000000000000000000000000000000000000000000000000001
               10000000000000000000000000000000000000000000000000000000000000001
11111111111111110000000000000000000000000000000000000000000000000000000000000001
10000000000000000000000000000000000000000000000000000000000000000000000000000001
10000000000000000000000000000000000000000000000000000000000000000000000000000001
10000000000000000000000000000000000000000000000000000000000000000000000000000001
10000000000000000000000000000000000000000000000000000000000000000000000000000001
10000000000000000000000000000000000000000000000000000000000000000000000000000001
11111111111111111111111111111111111111111111111111111111111111111111111111111111