NO ./textures/wall.png
SO ./textures/floor.png		    
W ./textures/brickwall.png 
EA ./textures/wintertrees.png			

F 113,66,52
C 100,149,237

DO

1111111111111111111
1000000000000000001111111111
1000000000000000000000000001
1000000000000N00000001111111
100000000000011111111
111100000000011111111
   100000000001
   111111111111