NO ./textures/wall.png
SO ./textures/floor.png		    
WE ./textures/brickwall.png 
EA ./textures/wintertrees.png			
DO ./textures/woodendoor.png 
F 113,66,52
C 100,149,237

        1111111111111111111111111
        1000000000110000000000001
        1011000011110000000000001
        100100000000000c0000S0001
111111111011000001110000000000001
100000DDD00000000111011111D111111
11110111111111011000000010001
1111D111111111011101010010001
11000000110101011100000010001
10000000000000001100000010001
10000000000000001101010010001
1100000111010101111101111000111
11110111 1110101 101111010001
11111111 1111111 111111111111



